########
# %   ##
# # ## #
# #  % #
# ## # #
## ### #
## 1   #
########