###################
# %   ## #        #
# # ##   #        #
# #  % ###    »   #
# ## #   #        #
## ### # #        #
##     # #        #
#     ## #        #
# # ##            #
# #  %       1    #
# ## #            #
## ### # #        #
###################
