##########
# %   ## #
# # ##   #
# #  % ###
# ## #   #
## ### # #
##     # #
# %   ## #
# # ##   #
# #  % ###
# ## #   #
## ### # #
##  1  # #
# %   ## #
# # ##   #
# #  % ###
# ## #   #
## ### # #
##     # #
##########
